+---+---+---+---+---+---+---+---+---+---+;
|...........|...|...........|.......|...|;
+...+...+---+...+---+---+...+...+---+...+;
....|...........|...|...................|;
+...+---+...+---+...+---+---+...+...+...+;
|.......|.......|...............|...|...|;
+---+...+...+---+---+---+---+---+...+---+;
|.......|...........................|...|;
+---+---+---+---+---+---+---+...+---+...+;
|...|.......................|.......|...|;
+...+---+...+...+---+---+---+...+---+...+;
|...|.......|...|.......|...............|;
+...+...+---+...+...+---+...+...+---+---+;
|.......|...|...|...........|...|.......|;
+...+---+...+...+---+...+---+...+---+...+;
|...|...|...........|.......|.......|...|;
+---+...+...+---+...+---+---+...+---+...+;
|.......|...|............................;
+...+...+...+---+...+---+---+...+---+---+;
|...|...........|.......|...............|;
+---+---+---+---+---+---+---+---+---+---+;
