+---+---+---+---+---+---+---+---+---+---+;
|...........|...........................|;
+---+---+...+...+---+...+---+---+---+---+;
........|.......|...|.......|...........|;
+...+---+...+---+...+---+---+---+...+---+;
|...........|...|...................|...|;
+---+---+...+...+...+...+---+...+...+...+;
|...........|.......|.......|...|.......|;
+---+...+---+...+---+---+...+---+---+---+;
|.......|...........|.......|...|.......|;
+...+---+...+---+---+...+---+...+---+...+;
|...............|...........|...|.......|;
+...+---+...+---+---+---+---+...+...+---+;
|.......|...........|...|...........|...|;
+...+---+...+---+...+...+...+---+---+...+;
|.......|...|...........................|;
+---+...+...+...+...+---+---+---+---+...+;
|.......|...|...|.......|...|...|........;
+---+...+---+---+...+...+...+...+---+---+;
|...........|.......|...................|;
+---+---+---+---+---+---+---+---+---+---+;

