+---+---+---+---+---+---+---+---+---+---+;
|...........|.......|...|...|...|.......|;
+---+---+...+...+...+...+...+...+---+...+;
................|...........|...|.......|;
+---+---+...+---+---+...+---+...+---+...+;
|...|.......|...............|.......|...|;
+...+...+---+...+---+---+...+---+...+...+;
|.......|...........|...................|;
+---+...+---+...+...+---+...+---+...+...+;
|.......|...|...|.......|.......|...|...|;
+---+---+...+---+...+...+...+---+---+...+;
|...........|.......|...|...|...........|;
+---+---+...+...+...+...+---+...+...+---+;
|.......|...|...|...|.......|...|.......|;
+---+...+...+---+...+---+---+---+---+...+;
|.......|...........|...........|.......|;
+---+...+...+...+---+...+---+---+---+---+;
|.......|...|............................;
+...+---+---+...+---+---+---+...+...+---+;
|.......................|.......|.......|;
+---+---+---+---+---+---+---+---+---+---+;

